Maniac Mansion|maniac
Zak McKracken and the Alien Mindbenders|zak
Indiana Jones and the Last Crusade|indy3
Loom|loom
Passport to Adventure|pass
The Secret of Monkey Island|monkey
Monkey Island 2: LeChuck's Revenge|monkey2
Indiana Jones and the Fate of Atlantis|atlantis
Day of the Tentacle|tentacle
Sam & Max Hit the Road|samnmax
Full Throttle|ft
The Dig|dig
The Curse of Monkey Island|comi
Leather Goddesses of Phobos 2|lgop2
The Manhole|manhole
Return to Zork|rtz
Rodney's Funscreen|rodney
Elvira - Mistress of the Dark|elvira1
Elvira II - The Jaws of Cerberus|elvira2
Personal Nightmare|pn
Simon the Sorcerer 1|simon1
Simon the Sorcerer 2|simon2
Simon the Sorcerer's Puzzle Pack - D.I.M.P.|dimp
Simon the Sorcerer's Puzzle Pack - Jumble|jumble
Simon the Sorcerer's Puzzle Pack - NoPatience|puzzle
Simon the Sorcerer's Puzzle Pack - Swampy Adventures|swampy
The Feeble Files|feeble
Waxworks|waxworks
Bargon Attack|bargon
Fascination|fascination
Geisha|geisha
Gobliiins|gob1
Gobliins 2|gob2
Goblins 3|gob3
Lost in Time|lostintime
Once Upon A Time: Little Red Riding Hood|littlered
Playtoons: Bambou le Sauveur de la Jungle|bambou
The Bizarre Adventures of Woodruff and the Schnibble|woodruff
Urban Runner|urban
Ween: The Prophecy|ween
Beneath a Steel Sky|sky
Broken Sword: The Shadow of the Templars|sword1
Broken Sword II: The Smoking Mirror|sword2
Lure of the Temptress|lure
The Black Cauldron|bc
Gold Rush!|goldrush
King's Quest I|kq1
King's Quest II|kq2
King's Quest III|kq3
King's Quest IV|kq4
Leisure Suit Larry in the Land of the Lounge Lizards|lsl1
Mixed-Up Mother Goose (AGI)|mixedup
Manhunter 1: New York|mh1
Manhunter 2: San Francisco|mh2
Police Quest I: In Pursuit of the Death Angel|pq1
Space Quest I: The Sarien Encounter|sq1
Space Quest II: Vohaul's Revenge|sq2
Fanmade Games|agi-fanmade
Mickey's Space Adventure|mickey
Troll's Tale|troll
Winnie the Pooh in the Hundred Acre Wood|winnie
Castle of Dr. Brain (EGA and VGA)|castlebrain
Codename: ICEMAN|iceman
Conquests of Camelot|camelot
Conquests of the Longbow (EGA and VGA)|longbow
EcoQuest: The Search for Cetus|ecoquest
EcoQuest 2: Lost Secret of the Rainforest|ecoquest2
Freddy Pharkas: Frontier Pharmacist|freddypharkas
Hoyle's Book of Games 1|hoyle1
Hoyle's Book of Games 2|hoyle2
Hoyle's Book of Games 3 (EGA and VGA)|hoyle3
Hoyle Classic Card Games|hoyle4
Jones in the Fast Lane|jones
King's Quest I (SCI remake)|kq1sci
King's Quest IV (SCI version)|kq4sci
King's Quest V (EGA and VGA)|kq5
King's Quest VI (low and hi res)|kq6
Laura Bow: The Colonel's Bequest|laurabow
Laura Bow 2: The Dagger of Amon Ra|laurabow2
Leisure Suit Larry 1 (SCI remake) (EGA and VGA)|lsl1sci
Leisure Suit Larry 2|lsl2
Leisure Suit Larry 3|lsl3
Leisure Suit Larry 5 (EGA and VGA)|lsl5
Leisure Suit Larry 6 (low res)|lsl6
Mixed-up Fairy Tales|fairytales
Mixed-up Mother Goose|mothergoose
Pepper's Adventures in Time|pepper
Police Quest 1 (SCI remake)|pq1sci
Police Quest 2|pq2
Police Quest 3 (EGA and VGA)|pq3
Quest for Glory 1/Hero's Quest|qfg1
Quest for Glory 1 VGA remake|qfg1vga
Quest for Glory 2|qfg2
Quest for Glory 3|qfg3
Slater & Charlie Go Camping|slater
Space Quest I (SCI remake) (EGA and VGA)|sq1sci
Space Quest III|sq3
Space Quest IV (EGA and VGA)|sq4
Space Quest V|sq5
The Island of Dr. Brain|islandbrain
3 Skulls of the Toltecs|toltecs
Amazon: Guardians of Eden|access
Beavis and Butt-head in Virtual Stupidity|bbvs
Blue Force|blueforce
Broken Sword 2.5: The Return of the Templars|sword25
Bud Tucker in Double Trouble|tucker
Chivalry is Not Dead|chivalry
Cruise for a Corpse|cruise
DreamWeb|dreamweb
Discworld|dw
Discworld II - Missing presumed...!?|dw2
Dragon History|draci
Drascula: The Vampire Strikes Back|drascula
Eye of the Beholder|eob
Eye of the Beholder II: The Legend of Darkmoon|eob2
Flight of the Amazon Queen|queen
Future Wars|fw
Hopkins FBI|hopkins
Hugo's House of Horrors|hugo1
Hugo 2: Whodunit?|hugo2
Hugo 3: Jungle of Doom|hugo3
I Have No Mouth, and I Must Scream|ihnm
Inherit the Earth: Quest for the Orb|ite
Lands of Lore: The Throne of Chaos|lol
Mortville Manor|mortevielle
Nippon Safes Inc.|nippon
Rex Nebular and the Cosmic Gender Bender|nebular
Ringworld: Revenge Of The Patriarch|ringworld
Return to Ringworld|ringworld2
Sfinx|sfinx
Soltys|soltys
The Journeyman Project: Pegasus Prime|pegasus
The Labyrinth of Time|lab
The Legend of Kyrandia|kyra1
The Legend of Kyrandia: Book Two: Hand of Fate|kyra2
The Legend of Kyrandia: Book Three: Malcolm's Revenge|kyra3
The Lost Files of Sherlock Holmes: The Case of the Serrated Scalpel|scalpel
The Lost Files of Sherlock Holmes: The Case of the Rose Tattoo|rosetattoo
The Neverhood|neverhood
The 7th Guest|t7g
TeenAgent|teenagent
Toonstruck|toon
Tony Tough and the Night of Roasted Moths|tony
Touche: The Adventures of the Fifth Musketeer|touche
Voyeur|voyeur
Zork: Grand Inquisitor|zgi
Zork Nemesis: The Forbidden Lands|znemesis
Backyard Baseball|baseball
Backyard Baseball 2001|baseball2001
Backyard Baseball 2003|baseball2003
Backyard Football|football
Backyard Football 2002|football2002
Bear Stormin'|brstorm
Big Thinkers First Grade|thinker1
Big Thinkers Kindergarten|thinkerk
Blue's 123 Time Activities|Blues123Time
Blue's ABC Time Activities|BluesABCTime
Blue's Art Time Activities|arttime
Blue's Birthday Adventure|BluesBirthday
Blue's Reading Time Activities|readtime
Blue's Treasure Hunt|BluesTreasureHunt
Fatty Bear's Birthday Surprise|fbear
Fatty Bear's Fun Pack|fbpack
Freddi Fish 1: The Case of the Missing Kelp Seeds|freddi
Freddi Fish 2: The Case of the Haunted Schoolhouse|freddi2
Freddi Fish 3: The Case of the Stolen Conch Shell|freddi3
Freddi Fish 4: The Case of the Hogfish Rustlers of Briny Gulch|freddi4
Freddi Fish 5: The Case of the Creature of Coral Cove|freddicove
Freddi Fish and Luther's Maze Madness|maze
Freddi Fish and Luther's Water Worries|water
Let's Explore the Airport with Buzzy|airport
Let's Explore the Farm with Buzzy|farm
Let's Explore the Jungle with Buzzy|jungle
Pajama Sam: Games to Play on Any Day|pjgames
Pajama Sam 1: No Need to Hide When It's Dark Outside|pajama
Pajama Sam 2: Thunder and Lightning Aren't so Frightening|pajama2
Pajama Sam 3: You Are What You Eat From Your Head to Your Feet|pajama3
Pajama Sam's Lost & Found|lost
Pajama Sam's Sock Works|socks
Putt-Putt Enters the Race|puttrace
Putt-Putt Goes to the Moon|puttmoon
Putt-Putt Joins the Circus|puttcircus
Putt-Putt Joins the Parade|puttputt
Putt-Putt Saves the Zoo|puttzoo
Putt-Putt Travels Through Time|putttime
Putt-Putt and Pep's Balloon-O-Rama|balloon
Putt-Putt and Pep's Dog on a Stick|dog
Putt-Putt & Fatty Bear's Activity Pack|activity
Putt-Putt's Fun Pack|funpack
SPY Fox 1: Dry Cereal|spyfox
SPY Fox 2: Some Assembly Required|spyfox2
SPY Fox 3: Operation Ozone|spyozon
SPY Fox in Cheese Chase|chase
SPY Fox in Hold the Mustard|mustard
Darby the Dragon|darby
Gregory and the Hot Air Balloon|gregory
Magic Tales: Liam Finds a Story|liam
The Princess and the Crab|princess
Sleeping Cub's Test of Courage|sleepingcub
Aesop's Fables: The Tortoise and the Hare|tortoise
Arthur's Birthday|arthurbday
Arthur's Teacher Trouble|arthur
Dr. Seuss's ABC|seussabc
Green Eggs and Ham|greeneggs
Harry and the Haunted House|harryhh
Just Grandma and Me|grandma
Little Monster at School|lilmonster
Ruff's Bone|ruff
Sheila Rae, the Brave|sheila
Stellaluna|stellaluna
The Berenstain Bears Get in a Fight|bearfight
The Berenstain Bears in the Dark|beardark
The New Kid on the Block|newkid
